1 1 1 1
1 0 5 2 1
1 0 5 0 1
1 3 4 0 1
1 1 1 1